last	minute	reprieve	1
data	acquisition	systems	1
double	accounting	system	1
income	tax	law	1
heavy	metal	types	1
advanced	technology	initiative	1
other	revenue	bill	0
seven	major	languages	0
dramatic	high	points	0
111	rare	snakes	0
opulent	life	style	0
effective	tax	rates	0
new	tax	provisions	0
major	buying	binge	0
regional	theater	establishment	0
outlawed	Palestinian	flag	0
major	Chinese	leaders	0
combined	1988	sales	0
small	gift	shops	0
lavish	white	portico	0
two	other	productions	0
current	filing	fee	0
new	fashion	trends	0
first	nine	months	0
next	several	years	0
other	four	units	0
archaic	Filipino	word	0
chief	operating	officer	0
individual	retirement	account	0
exact	same	situation	0
leading	Republican	proponent	0
special	tax	breaks	0
first	contract	year	0
French	chemical	company	0
Arab	pasta	maker	0
chief	executive	officer	0
requisite	60	votes	0
old	regional	divisions	0
global	retailing	network	0
only	Japanese	retailer	0
first	five	days	0
overseas	merchandising	offices	0
narrow	American	strategy	0
annual	appropriations	measures	0
one	recent	episode	0
most	Philippine	children	0
daily	television	show	0
famous	specialty	shops	0
enlarged	wire	cage	0
corporate	tax	bills	0
Japanese	department	store	0
American	real	estate	0
federal	income	tax	0
federal	income	taxes	0
racy	weekly	magazines	0
European	department	store	0
good	political	sense	0
one	investment	banker	0
past	12	months	0
many	other	areas	0
Philippine	class	structure	0
